#####.###
.....#...
..#.....#
@........
#######..
..####...
.........